11111111111111111111
1CCC1CCCCCCC00000001
1CCC1CCCCCCC00000001
1CCC1CCCCCCC00000001
1CCC1CCCCCCC00000001
1CCC1CCCCCCC00000001
1CCCCCCCC1CC00000001
1CCCCCCCC1CC00000001
1ECCCCCCC1CC00000P01
11111111111111111111
