1111111111111
1CCCCCCCCCCC1
1CCCCCCCCCCC1
1CCCCCCCCCCC1
1CCCCCCCCCC01
1CCCCCCCCCCC1
1CC1CCCCCMMC1
1CCCC11111001
1PCC10ECC0CC1
1111111111111
