1111111111111111111111111111111
1P00000000000000000000000000001
1111111111111111111111111111101
1000000000000000000000000000001
1011111111111111111111111111111
10000000C00000C00000000C0000001
1111111111111111111111111111101
10000000000C0000000000000000001
1111111111111111111111111111101
1111111111111111111111111111101
10000000000C0000000000000000001
1111111111111111111111111111101
10000000000C0000000000000000001
1111111111111111111111111111101
1111111111111111111111111111101
10000000000C0000000000000000001
10000000000C0000000000000000001
1111111111111111111111111111101
100000000000000C000000000000001
1E00000000000000C00000000000001
1111111111111111111111111111111
